                
              + 
              + 
            o...
    !      o    
          o     
..........O.....
....i......O....
............O   
..............-.
..............-.
................
................
................
................
