                
                
              + 
              + 
        g  vvvvv
       ... .....
......     .....
...  .     .....
......^^^^^.....
........G.......
.............   
..............-.
..............-.
................
................
