                
                
              + 
              + 
           vvvvv
       ... .....
......     .....
......     .....
.... .     .....
......^^^^^.....
................
.............   
..............-.
..............-.
................
