                
                
              + 
              + 
           vvvvv
       ... .....
......     .....
...  .     .....
......^^^^^.....
................
.............   
..............-.
..............-.
................
................
