v                                               
.                                               
.                                               
.                                               
.                                             + 
.                                             + 
...X.-.=...........  ............        .......
...X.-.=...........  ............      .........
...X...=...........  ............    ...........
========...........  ............    ...........
...................  ............    ...........
...................  ............    ...........
...................  ............^^^^...........
........                    ....................
........                    ....................
........                    ....................
........   ..............   ....................
........   ..............   ....................
........   ..............   ....................
........   ..............   ....................
........   ...                        ..........
........   ... !                      ..........
........   ...                        ..........
........   ........................   ..........
........   ........................   ..........
........   ........................   ..........
........   ........................   ..........
........   ........................   ..........
........   ..................                   
........   ..................                 + 
........^^^..................                 + 
.............................   ................
.............................   ................
.............................   ................
.............................   ................
.............................^^^................
