                
                
              + 
              + 
        s  vvvvv
       ... .....
......     .....
... ..     .....
......^^^^^.....
........S.......
.............   
..............-.
..............-.
................
................
